{
    "fin": [ 5, 5 ],
    "perso": [ 1, 1, 1 ],
    "cases": [
        [1, 1, 1, 1, 1, 1, 1, 1, 1, 1],
        [1, 0, 1, 0, 0, 0, 0, 0, 0, 1],
        [1, 0, 1, 0, 1, 1, 1, 0, 1, 1],
        [1, 0, 0, 0, 0, 0, 1, 0, 0, 1],
        [1, 1, 1, 0, 1, 1, 1, 1, 1, 1],
        [1, 0, 1, 0, 1, 0, 0, 0, 0, 1],
        [1, 0, 0, 0, 1, 1, 1, 1, 0, 1],
        [1, 0, 1, 0, 1, 0, 0, 1, 0, 1],
        [1, 0, 1, 0, 1, 0, 1, 1, 0, 1],
        [1, 0, 1, 0, 1, 0, 0, 0, 0, 1],
        [1, 0, 1, 0, 1, 0, 1, 1, 1, 1],
        [1, 0, 1, 0, 1, 0, 0, 0, 0, 1],
        [1, 0, 1, 1, 1, 1, 0, 1, 1, 1],
        [1, 0, 0, 0, 0, 0, 0, 0, 0, 1],
        [1, 1, 1, 1, 1, 1, 1, 1, 1, 1]
    ]
}
